0,0,0,3,3,0,0
3,3,0,3,4,0,0
1,3,3,2,3,3,0
4,2,0,3,3,3,0
3,3,3,0,3,3,0
3,3,3,0,0,3,0
3,0,0,0,0,0,0
